[MAP]
##############################
#                            #
#                            #
#                            #
#                            #
#                            #
#                            #
#                            #
#                            #
#                            #
#                            #
#                            #
#                            #
#                            #
#  P                      G  #
##############################
##############################
[OBJECTS]
