[MAP]
############################################################
#                                                          #
#                                                          #
#                                                          #
#                                                          #
#                                                          #
#                                                          #
#                                                          #
#                                                          #
#                                                          #
#                                                          #
#                                                          #
#                                                          #
#                                                          #
#                                                          #
#                                                          #
#                                                          #
#                                                          #
#                                                          #
#                                                          #
#                                                          #
#                                                          #
#                                                          #
#          ^^                    C                         #
#       #######                  C                         #
#                             #######                      #
#                                               #########  #
#                                                          #
#                                                          #
#  P     J          ^^^^^^                                 #
########################################      ##############
########################################      ##############
########################################      ##############
[OBJECTS]
# 파라미터형 객체 — 타입 인자... (좌표/크기는 픽셀, RopeNTT 좌표는 천장 피벗)
# platform x y w h axis dist speed | spring x y w h dir | ntt x y | ropentt pivot_x pivot_y | enemy x y | armored x y
platform 320 360 90 14 x 160 1.4
platform 800 300 64 14 y 150 1.2
spring 800 400 16 16 up
spring 16 336 6 32 right
ntt 256 416
ntt 208 466
enemy 432 464
armored 544 464
ropentt 520 320
